Fondly - in a way that shows love or great liking
Spring - a place where water naturally flows out from the ground
Vital - necessary for the success or continued existence of something; extremely important
Well - a deep hole in the ground from which you can get water, oil, or gas
Surpass - to do or be better or greater than something
Outline - a description of the main facts about something
Extent - the degree or limit of something; how great or severe something is
Replenish - to fill something up again
Dam - a wall built across a river that stops the river's flow and collects the water, especially to make a reservoir (= an artificial lake) that provides water for an area
Arrange - to plan, prepare for, or organize something
Reservoir - a place for storing liquid, especially a natural or artificial lake providing water for a city or other area
Plentiful - there is a lot of it available
Leaky - Something that is leaky has a hole or crack in it that allows liquid or gas to get through
Plumbing - the water pipes and similar systems in a building
Inherit - to begin to have responsibility for a problem or situation that previously existed or belonged to another person
Tank - a container that holds liquid or gas
Assure - to cause something to be certain
Desalination - the process of removing salt from sea water
Dedication - the willingness to give a lot of time and energy to something because it is important
Resourcefulness - the ability to make decisions and act on your own
Completion - the act of finishing something that you are doing or making
Secretive - not wanting others to know, or done privately so that others do not know
Diameter - a straight line that reaches from one point on the edge of a round shape or object, through its centre, to a point on the opposite edge
Particle - an extremely small piece of matter, that together with others makes up an atom
Overtake - to go past something by being a greater amount or degree
Beam - a line of light that shines from a bright object
Steer - to take someone or something or make someone or something go in the direction in which you want him, her, or it
Foundation - an idea or fact that something is based on
Riddle - something that is confusing, or a problem that is difficult to solve
Circumference - the line surrounding a circular space, or the length of this line
Immense - extremely large in size or degree
Solenoid - a device, consisting of a wire wrapped in the shape of a cylinder, that acts like a magnet when electricity goes through it
Prudent - careful and avoiding risks
Dense - containing a lot of matter in a small space
Pea - a round, green seed, several of which grow in a pod, eaten as a vegetable
Obliterate - to remove all signs of something, either by destroying it or by covering it so that it cannot be seen
Burst - to break open or apart suddenly, or to make something do this
Stretch (of the river) - a continuous area of land or water
Brain drain - the situation in which large numbers of educated and very skilled people leave their own country to live and work in another one where pay and conditions are better
Flood (of data) - a large amount or number of something
Recycling plant - a place where materials are changed so that they can be used again
Rife with - full of something unpleasant
(water) tap - a device that controls the flow of liquid, especially water, from a pipe
(water) meters - a device that measures the amount of something that is used
Water table - the level below the surface of the ground at which you start to find water
Divert - to cause something or someone to change direction
Explosion (of well digging) - a large increase in the number of something that happens very quickly
Wetlands - an area of land that is naturally wet
Household - a group of people, often a family, who live together
Discern - to see, recognize, or understand something that is not clear
Boast - to speak too proudly or happily about what you have done or what you own
Be willing - to be happy to do something if it is needed
Labor - refers to the workers themselves, esp. those who do practical work with their hands
Whereby - by which way or method
Interject - to say something while another person is speaking
Derived - coming from or caused by something else
Coherent - it is clear and carefully considered, and each part of it connects or follows in a natural or reasonable way
Bubble up - to rise to the surface or become obvious
Self reliant - the quality of not needing help or support from other people
waste disposal - an electrical machine, connected to a kitchen sink, that cuts up food waste so that it will flow easily through the pipes
